A	AH
A(2)	EY
AM	AE M
AM(2)	EY EH M
ASSISTANCE	AH S IH S T AH N S
DONE	D AH N
FINISHED	F IH N IH SH T
GUIDANCE	G AY D AH N S
HAND	HH AE N D
HELP	HH EH L P
HELPING	HH EH L P IH NG
I	AY
I'M	AY M
I'M(2)	AH M
IS	IH Z
IT	IH T
LIKE	L AY K
ME	M IY
NEED	N IY D
OK	OW K EY
SERVICE	S ER V AH S
SERVICE(2)	S ER V IH S
SET	S EH T
SOME	S AH M
SUPPORT	S AH P AO R T
THAT	DH AE T
THAT(2)	DH AH T
THAT'S	DH AE T S
WOULD	W UH D
